10.ox
oo....ooo.
oo..o..ooo
..o.o..o..
..o...o..o
oo..ooo.o.
o.oooo...o
.oooo..ooo
o.oo.o.ooo
ooo..oo.o.
..oo.o.o.o
